92222222222222222222222222222224
92222222222222222222222222222224
92222777777222222222222222222224
92222777777222222222222222222224
92222222888222222222222222222224
92222222222222277722222222222224
92222222222222277722222222222224
92222222222222222222222222222224
92222222222222222222222222222224
92222222222222222222222222222224
92222222222222222222222222222224
92222222222277722222222222222224
92222222222222222222222222222224
92222222222222222222222222222224
92222222222222222222222222222224
92222222222222222222777222222224
92222222222222222222222222222224
92222222222222222222222222222224
92222222222222222222222222222224
92222222222222222222222222222224
92222222222222222222222222222224
92222222222222222222222222222224
92222227772222222222222222222224
92222227772222222226662222222224
92222222222222222222222222222224
92222222222222222222222222222224
92222222222222222222222222222224
92222222222222222888822222222224
92222222222222222222222222222224
92222222222222222222222222222224
92222222222222222222222222222224
92222222222222222222222222222224
92222222222222222222222222222224
92222222222222222222222222222224
92222777777222222222222222222224
92222777777222222222222222222224
92222222888222222222222222222224
92222222222222277722222222222224
92222222222222277722222222222224
92222222222222222222222222222224
92222222222222222222222222222224
92222222222222222222222222222224
92222222222222222222222222222224
92222222222277722222222222222224
92222222222222222222222222222224
92222222222222222222222222222224
92222222222222222222222222222224
92222222222222222222777222222224
92222222222222222222222222222224
92222222222222222222222222222224
92222222222222222222222222222224
92222222222222222222222222222224
92222222222222222222222222222224
92222222222222222222222222222224
92222227772222222222222222222224
92222227772222222226662222222224
92222222222222222222222222222224
92222222222222222222222222222224
92222222222222222222222222222224
92222222222222222888822222222224
92222222222222222222222222222224
92222222222222222222222222222224
92222222222222222222222222222224
92222222222222222222222222222224